-------------------------
-                       -
-                       -
-                       -
-            --         -
-                       -
-                       -
-                       -
--                   ----
-                       -
-                       -
-      ---              -
-                       -
-   -----------         -
-                       -
-                -      -
-                   --  -
-                       -
-                       -
-------------------------