-------------------------
-         0             -
-                       -
-                       -
-            --         -
-                       -
-      0                -
-                      E-
--                  -----
-                       -
-                       -
-      ---              -
-                       -
-   -----------         -
-                       -
-                -      -
-                   --  -
-                       -
- @                  0  -
-------------------------