-----------------------------------------
-                                       -
-      ---                              -
-                                      --
-                            --         -
-                                       -
-                                       -
-           ---                         -
--                                  -----
-                                       -
-                                       -
-      -   -           ---              -
-                                       -
-                   -----------         -
---                                     -
-         --                     -      -
-                                   --  -
-                    ---                -
-                                       -
-       -------                         -
-                              --       -
-                                       -
-----------------------------------------