----------------------------------------------------------------------------------------------------------------
----------------------------------------------------------------------------------------------------------------
----------------------------------------------------------------------------------------------------------------
----------------------------------------------------------------------------------------------------------------
----------------------------------------------------------------------------------------------------------------
----------------------------------------------------------------------------------------------------------------
----------------------------------------------------------------------------------------------------------------
----------------------------------------------------------------------------------------------------------------
----------------------------------------------------------------------------------------------------------------
-------------------           ----------------------------------------------------------------------------------
-------------------           <---------------------------------------------------------------------------------
------------------- @           -------->          VVVVVVVV                               ----------------------
--------------------------      -------->                                                 ----------------------
--------------------------                                                    0          E----------------------
--------------------------                                            --|||--|-|---|||||------------------------
--------------------------    -----------   -    --      -        --  ------------------------------------------
--------------------------    -----------                             ------------------------------------------
--------------------------0   -----------                             ------------------------------------------
--------------------------||||-----------||||||||||||||||0||||||||||||------------------------------------------
----------------------------------------------------------------------------------------------------------------
----------------------------------------------------------------------------------------------------------------
----------------------------------------------------------------------------------------------------------------
----------------------------------------------------------------------------------------------------------------
----------------------------------------------------------------------------------------------------------------
----------------------------------------------------------------------------------------------------------------